NO ./textures/antauber.xpm
SO ./textures/tcyback.xpm
WE ./textures/ebervas.xpm
EA ./textures/ael-atmi.xpm

F 0,229,255
C 255,0,235     1111111
1111111
100W001
1111111