NO ./textures/NO.xpm
SO ./textures/SO.xpm
WE ./textures/WE.xpm
EA ./textures/EA.xpm

F 102,64,9
C 70,193,243

11111111111
10000000001
10000000001
11000E00001
10000000001111111111
10000000001
11111111111