SO         ./textures/tcyback.xpm
WE ./textures/ebervas.xpm
NO ./textures/antauber.xpm
EA ./textures/ael-atmi.xpm

F 0,229,255
C 255,0,235

1111111111111111111
1000000010001111001
1110001110000111001
1110001110010011001
1110001110011001001
1110001110011100001
1110001110011110001
10000000W0011111001
1111111111111111111