F 00000000000000000000000000000000000000000000000000000000, 102, 107
NO  			 ./textures/antauber.xpm
SO ./textures/tcyback.xpm
WE ./textures/test.xpm
EA ./textures/test2.xpm

C 0,000000000,000000000000000000255

11  111111 11111
111100001 1     1
1E00000        1
111111111111111
