SO ./textures/tcyback.xpm
WE ./textures/ebervas.xpm
NO ./textures/antauber.xpm
EA ./textures/ael-atmi.xpm

F 0,229,255
C 255,0,235

1111111111111111111111111111111111111111111111111111111111111111111111111111
1E00000000000000000000000000000000000000000000000000000000000000000000000001
1111111111111111111111111111111111111111111111111111111111111111111111111111
